2048 1024 512
12 12 12 12 12 12 166 166 166 166 166 166 166 166 166 166 12 12 12 12 12 12 166 166 166 166 166 166 166 166 166 166
12 166 166 166 166 166 166 12 12 12 12 60 12 12 12 12 12 166 166 166 166 166 166 12 12 12 12 60 12 12 12 12
166 166 12 12 12 12 12 12 89 89 89 89 89 89 89 89 166 166 12 12 12 12 12 12 89 89 89 89 89 89 89 89
12 166 12 12 60 12 89 89 89 12 166 166 166 12 12 12 12 166 12 12 60 12 89 89 89 12 166 166 166 12 12 12
12 166 166 12 89 89 89 12 12 12 166 166 166 60 12 12 12 166 166 12 89 89 89 12 12 12 166 166 166 60 12 12
12 12 166 12 89 12 60 60 12 12 166 166 166 166 60 12 12 12 166 12 89 12 60 60 12 12 166 166 166 166 60 12
60 12 166 12 89 12 60 60 60 12 166 166 166 166 166 166 60 12 166 12 89 12 60 60 60 12 166 166 166 166 166 166
12 12 166 12 89 60 60 60 12 12 12 12 166 166 166 166 12 12 166 12 89 60 60 60 12 12 12 12 166 166 166 166
12 12 12 12 12 12 166 166 166 166 166 166 166 166 166 166 12 12 12 12 12 12 166 166 166 166 166 166 166 166 166 166
12 166 166 166 166 166 166 12 12 12 12 60 12 12 12 12 12 166 166 166 166 166 166 12 12 12 12 60 12 12 12 12
166 166 12 12 12 12 12 12 89 89 89 89 89 89 89 89 166 166 12 12 12 12 12 12 89 89 89 89 89 89 89 89
12 166 12 12 60 12 89 89 89 12 166 166 166 12 12 12 12 166 12 12 60 12 89 89 89 12 166 166 166 12 12 12
12 166 166 12 89 89 89 12 12 12 166 166 166 60 12 12 12 166 166 12 89 89 89 12 12 12 166 166 166 60 12 12
12 12 166 12 89 12 60 60 12 12 166 166 166 166 60 12 12 12 166 12 89 12 60 60 12 12 166 166 166 166 60 12
60 12 166 12 89 12 60 60 60 12 166 166 166 166 166 166 60 12 166 12 89 12 60 60 60 12 166 166 166 166 166 166
12 12 166 12 89 60 60 60 12 12 12 12 166 166 166 166 12 12 166 12 89 60 60 60 12 12 12 12 166 166 166 166
12 12 12 12 12 12 166 166 166 166 166 166 166 166 166 166 12 12 12 12 12 12 166 166 166 166 166 166 166 166 166 166
12 166 166 166 166 166 166 12 12 12 12 60 12 12 12 12 12 166 166 166 166 166 166 12 12 12 12 60 12 12 12 12
166 166 12 12 12 12 12 12 89 89 89 89 89 89 89 89 166 166 12 12 12 12 12 12 89 89 89 89 89 89 89 89
12 166 12 12 60 12 89 89 89 12 166 166 166 12 12 12 12 166 12 12 60 12 89 89 89 12 166 166 166 12 12 12
12 166 166 12 89 89 89 12 12 12 166 166 166 60 12 12 12 166 166 12 89 89 89 12 12 12 166 166 166 60 12 12
12 12 166 12 89 12 60 60 12 12 166 166 166 166 60 12 12 12 166 12 89 12 60 60 12 12 166 166 166 166 60 12
60 12 166 12 89 12 60 60 60 12 166 166 166 166 166 166 60 12 166 12 89 12 60 60 60 12 166 166 166 166 166 166
12 12 166 12 89 60 60 60 12 12 12 12 166 166 166 166 12 12 166 12 89 60 60 60 12 12 12 12 166 166 166 166
12 12 12 12 12 12 166 166 166 166 166 166 166 166 166 166 12 12 12 12 12 12 166 166 166 166 166 166 166 166 166 166
12 166 166 166 166 166 166 12 12 12 12 60 12 12 12 12 12 166 166 166 166 166 166 12 12 12 12 60 12 12 12 12
166 166 12 12 12 12 12 12 89 89 89 89 89 89 89 89 166 166 12 12 12 12 12 12 89 89 89 89 89 89 89 89
12 166 12 12 60 12 89 89 89 12 166 166 166 12 12 12 12 166 12 12 60 12 89 89 89 12 166 166 166 12 12 12
12 166 166 12 89 89 89 12 12 12 166 166 166 60 12 12 12 166 166 12 89 89 89 12 12 12 166 166 166 60 12 12
12 12 166 12 89 12 60 60 12 12 166 166 166 166 60 12 12 12 166 12 89 12 60 60 12 12 166 166 166 166 60 12
60 12 166 12 89 12 60 60 60 12 166 166 166 166 166 166 60 12 166 12 89 12 60 60 60 12 166 166 166 166 166 166
12 12 166 12 89 60 60 60 12 12 12 12 166 166 166 166 12 12 166 12 89 60 60 60 12 12 12 12 166 166 166 166
12 12 12 12 12 12 166 166 166 166 166 166 166 166 166 166 12 12 12 12 12 12 166 166 166 166 166 166 166 166 166 166
12 166 166 166 166 166 166 12 12 12 12 60 12 12 12 12 12 166 166 166 166 166 166 12 12 12 12 60 12 12 12 12
166 166 12 12 12 12 12 12 89 89 89 89 89 89 89 89 166 166 12 12 12 12 12 12 89 89 89 89 89 89 89 89
12 166 12 12 60 12 89 89 89 12 166 166 166 12 12 12 12 166 12 12 60 12 89 89 89 12 166 166 166 12 12 12
12 166 166 12 89 89 89 12 12 12 166 166 166 60 12 12 12 166 166 12 89 89 89 12 12 12 166 166 166 60 12 12
12 12 166 12 89 12 60 60 12 12 166 166 166 166 60 12 12 12 166 12 89 12 60 60 12 12 166 166 166 166 60 12
60 12 166 12 89 12 60 60 60 12 166 166 166 166 166 166 60 12 166 12 89 12 60 60 60 12 166 166 166 166 166 166
12 12 166 12 89 60 60 60 12 12 12 12 166 166 166 166 12 12 166 12 89 60 60 60 12 12 12 12 166 166 166 166
12 12 12 12 12 12 166 166 166 166 166 166 166 166 166 166 12 12 12 12 12 12 166 166 166 166 166 166 166 166 166 166
12 166 166 166 166 166 166 12 12 12 12 60 12 12 12 12 12 166 166 166 166 166 166 12 12 12 12 60 12 12 12 12
166 166 12 12 12 12 12 12 89 89 89 89 89 89 89 89 166 166 12 12 12 12 12 12 89 89 89 89 89 89 89 89
12 166 12 12 60 12 89 89 89 12 166 166 166 12 12 12 12 166 12 12 60 12 89 89 89 12 166 166 166 12 12 12
12 166 166 12 89 89 89 12 12 12 166 166 166 60 12 12 12 166 166 12 89 89 89 12 12 12 166 166 166 60 12 12
12 12 166 12 89 12 60 60 12 12 166 166 166 166 60 12 12 12 166 12 89 12 60 60 12 12 166 166 166 166 60 12
60 12 166 12 89 12 60 60 60 12 166 166 166 166 166 166 60 12 166 12 89 12 60 60 60 12 166 166 166 166 166 166
12 12 166 12 89 60 60 60 12 12 12 12 166 166 166 166 12 12 166 12 89 60 60 60 12 12 12 12 166 166 166 16612 12 12 12 12 12 166 166 166 166 166 166 166 166 166 166 12 12 12 12 12 12 166 166 166 166 166 166 166 166 166 166
12 166 166 166 166 166 166 12 12 12 12 60 12 12 12 12 12 166 166 166 166 166 166 12 12 12 12 60 12 12 12 12
166 166 12 12 12 12 12 12 89 89 89 89 89 89 89 89 166 166 12 12 12 12 12 12 89 89 89 89 89 89 89 89
12 166 12 12 60 12 89 89 89 12 166 166 166 12 12 12 12 166 12 12 60 12 89 89 89 12 166 166 166 12 12 12
12 166 166 12 89 89 89 12 12 12 166 166 166 60 12 12 12 166 166 12 89 89 89 12 12 12 166 166 166 60 12 12
12 12 166 12 89 12 60 60 12 12 166 166 166 166 60 12 12 12 166 12 89 12 60 60 12 12 166 166 166 166 60 12
60 12 166 12 89 12 60 60 60 12 166 166 166 166 166 166 60 12 166 12 89 12 60 60 60 12 166 166 166 166 166 166
12 12 166 12 89 60 60 60 12 12 12 12 166 166 166 166 12 12 166 12 89 60 60 60 12 12 12 12 166 166 166 166
12 12 12 12 12 12 166 166 166 166 166 166 166 166 166 166 12 12 12 12 12 12 166 166 166 166 166 166 166 166 166 166
12 166 166 166 166 166 166 12 12 12 12 60 12 12 12 12 12 166 166 166 166 166 166 12 12 12 12 60 12 12 12 12
166 166 12 12 12 12 12 12 89 89 89 89 89 89 89 89 166 166 12 12 12 12 12 12 89 89 89 89 89 89 89 89
12 166 12 12 60 12 89 89 89 12 166 166 166 12 12 12 12 166 12 12 60 12 89 89 89 12 166 166 166 12 12 12
12 166 166 12 89 89 89 12 12 12 166 166 166 60 12 12 12 166 166 12 89 89 89 12 12 12 166 166 166 60 12 12
12 12 166 12 89 12 60 60 12 12 166 166 166 166 60 12 12 12 166 12 89 12 60 60 12 12 166 166 166 166 60 12
60 12 166 12 89 12 60 60 60 12 166 166 166 166 166 166 60 12 166 12 89 12 60 60 60 12 166 166 166 166 166 166
12 12 166 12 89 60 60 60 12 12 12 12 166 166 166 166 12 12 166 12 89 60 60 60 12 12 12 12 166 166 166 166
